111111111111111111
1000P00011000C0001
1001E1001100111001
100000001100000001
1001a10011001a1001
111111111111111111
