111111111111111111
1000P00011000E0001
100111001100111001
1000C0001100000001
1001a10011001a1001
111111111111111111
