111111111111111
1P000D000D00001
100001eee101y01
1111e11H11e1111
10y101eDe100001
100000000D000E1
111111111111111
