1111111111111111
11211e000e1e0D01
12P21e0e00000101
10001c0eee1eD101
1200211111111001
1120000000000011
1200211111111001
10001c2000000101
12E210100Be00101
1121100000000D01
1111111111111111
