11111111111
11111B11111
11100000111
1120020D011
11020020011
1E002S20ec1
11000220011
1100e00D011
111e0000111
11111P11111
11111111111
