111111111111111
111220b1Hs22111
11200001Dxs0z11
120P0001ss0D021
12000001s000s21
100000e100s0001
1x000ey1S0sssG1
111111121111111
1cDe00z1y0e20e1
1seB0001e2ee021
120000012e01021
12000B01020Ee21
11b00ed1e00e211
11122sO1ee22111
111111111111111
