11111111111111111
1P10000D00000e111
10100C011000eee11
1011E101S10eeeee1
101c11010101DDD11
100000010001HcDx1
11111111111111111
1x00e001110000001
110eee0011c100101
10e10ee0011HDc101
1e0Deece00C111101
1Ceec000D00C000C1
11111111111111111
