1111111111111111111111111
1P001100d000CC00dD01C00a1
100DH0011000CC0011c00B011
100110B11001c00011OO000c1
1DD110000001100d00dDc0001
1d000d0CC0000d1100DDc1111
10OD000CC110B0110CC01b001
1DbO00000a1000000CC01c0E1
1111111111111111111111111
