111111111111111111
111111111111111111
111C0000P00000C111
11x100011110001a11
110e100B000B010011
1100e100DD00100011
1e000e1DDDH1000011
1ee000e1xc100C0D11
11ee0D0e110000Dc11
111eeHDc110C0DcO11
11ee0D010z1000Dc11
1ee00e1c00010C0D11
1e00e1010d001O0011
110e100011DDD1cD11
11a100B0000B001z11
111cD000E000B0c111
111111111111111111
111111111111111111
