1111111111111111111111111111111
1CP10D0D0100D0e00000ccDC01000C1
1D1c01C100C0ec00CeC0e1010001a11
1001001cDC1Ce000eEe0e101111c1b1
1a0c1z1b00ceB0zHe000e0000C00001
1111111111111111111111111111111
