11111111111
1P0d00C00C1
111z1111101
1t1D1B0c101
100010C01C1
11111x001e1
1z0Cc11eab1
10e0D111111
1C0Dx1000E1
11111c0eee1
1tCa110CCb1
11111111111
