11111111111111111111111111111111111
1111DeDC00011111C00DcO0eee0000e1111
1111e0a0e00000011000D0ee000ee0e1z11
1111HeD0000dD00010ed00eDHeee00e1C11
1110000000000000C0ee0000011eDe11011
1000001110000DD11111Dd00001eee11001
1dd0000000000DCe0P0DDD0000111111101
1dddd000B0000HD11110DH0000000011001
1DD11111100000000000000000110000011
1DH1000C10000000000e00000B000000011
1DD10a0e11CC000001eEe10000000011111
1111000c1111CC0011eze10011111111111
11111111111111111111111111111111111
