1111111111111111111111
1cet111111DDDDH11111P1
100DH11t0D0DDD0Dc10001
11e0111MDDHD0HDD1000D1
100011110111B0H1e00D11
1011100y1H0D1110e010c1
1H0CC0110001O00000DOy1
1e0ee0a1c1x1D0CDH1D001
11111111111111111c1111
1Da0CCC00CCC00CCC0E0x1
11111111111111111c1111
