11111111111
1P0d00C00C1
111z1111101
1t1D1B0c101
100010C01C1
11111x00101
1z00H11eae1
10e0D111111
1C0Dx1c1E01
111111e01e1
1tCS110a001
11111111111
