1111111111111
1eedze1yD2ea1
1P001K1101He1
1eeHa11xd0dt1
1111c111111e1
1tBeDC10y10x1
11dE0De00e0e1
1bedC0C01z0b1
1111111111111
