1111111111111111111111111111111
1P000001000D102H00e0D12110Dy1E1
11111101D101a01112De1cD01011101
1t0H010111D01000D0012D001D0H1C1
12220D000010112e0e2210101101101
1000010e1D001000D00D2D1D10001C1
1D111100010110110e102z10001H101
1010000e1101c01D01M012H111c11C1
1y10e11D200H1H111e11D101000G101
12D02D00001ex10C01D0D10d01101C1
11e0D1HeD1111e0Be01e10010000101
10D02H111DDD00000M1d0D1D111d1C1
1011001D0111eD1eD11001H01000101
10e0a11e000H10110D110110001e1C1
1DeDeD011e0e10eH10010e1S11e02x1
1000e200000D1z01De0D0e2t1H02K21
111111111111111111111c111111211
