111cM111M1M11
1MDdDMPcHcHc1
1M1HdCKd01dDc
c0D11D10D10HM
1M01Mdc1cMdM1
1cDMCd11c0Dc1
1M01dDdeeHd0M
cDdDDMEdDC1c1
11M1111M1M111
