1111
1P01
10C1
1C01
10E1
1111
