111111111111111111111111111111111111
1PKKKKKKKKKKKKKKK1KKKKKKKKKKKKKKKKK1
1KKKKKKKKKKKKKKKK1KKKKKKKKKKKKKKKKK1
1KKKKKKKKKKKKKKKK1KKKKKKKKKKKKKKKKK1
1KKKKKKKKKKKKKKKK1KKKKaKKKKKKKKKKKK1
1KKKKKKKKKKKKKKKK1KKKKKKKKKKKKKKKKK1
1KKKKKKKKKKKKKKKt1KKKKKKKKKKKKKKKKt1
111111111111111111111111111111111111
1KKKKKKKKKKKKKKKx1KKKKKKKKKKKKKKKKK1
1KKKKKKKKKKKKKKKK1KKKKKKKKKKKKKKKKK1
1KKKKKKKKKKKKKKKK1xKKKKKKKKKKKKKKKK1
1KKKKKKKKKKKKKKKK1KKKKKKKKKKKKKKKKK1
1KKKKKKKKKKKKKKKK1KKKKKKKKKKKKKKKKK1
1KaKKKKKKKKKKKKKK1KKKKKKKKKKKKKKKKEc
111111111111111111111111111111111111
