11111111111111111
1001001DPD11CCCC1
1ae000c1D1Ea10001
10000000001e00001
111000100e0000e01
1Cc00000e000e0001
1CC00000000000CC1
11111111111111111
