1111111111111111111111111111
1P000b1H010CCWCCWCC000100001
1C111111d00111111110001dee01
1C1B0000010CCWCCWCC00000te01
1C10eee0W10eeeeeHeeeee010e01
1C10000Wa1000B00000000B1ce01
1C11111eeee1111111111111ee01
1WCCCC1H00c1yCCCCCz1Gy000001
1111111H001111e1eee1111111c1
1a0000111D000eze000e01b100E1
100B00Dc1eee00000e000100W1t1
1111111111111111111111111111
