1111111111111111111
1P00000000000000001
1000000DaSHa0000001
1000000000000000001
1000110000000000001
10000000M0xOO000001
1000000000000000001
1000C00000000000001
1000000000000xe10E1
1111111111111111111
