11111111111111111111111111111111111111111111111111111111111111111111111111111111111111111111111111111111111
111111111000C111111111111111111111111111111111111111111111111111111111111111111111111111CC111111111C1111111
1111110000111C000000001110000000C01110000000C111000000000111110000000001110000000C111000011111111100C111111
111110001111110001110001000000010111C0001110001110000000000100000000000000000000111000000000000000011111111
1111000111111C000000000000001000100111000011001110000C00000C0000111000000011000000000000000111100000000C111
111111001111110000011110000000000000000001000110000000000011111100000001111110000000001110001C0000000001111
11111000001111110000000010000000C10100000000000000001110000000111C00000001100000001111111111111111100000C11
1111111000C01111110000C001110000111000010000010000000011111111111111111000000111100000000011111111111111111
111110C000000011100000000000000001C0001000111111C0000000000000000C0C0C1111011100011111111111000011100000011
1101110000110000001000000C10000000000101110000C111111100000000011111111000000001000000000000000001100000011
110000111001111000000000000000000111100110C1111111C0000000C0000000C0C111110111111111110000000C000C0000000E1
11100111000001111110000111111111111111C100000000C1100000011111111111111111111111111111111110000011110001011
11000000000000001110000000000C00111C00000110000110001110001100C001110000000111000000000111111111111111111C1
1101011100111000000001110000000000111C00000000110001101100011000000001110000011100C000000000000011110000001
11000000000011100000111111000111000111000000001100110P01100001111111111000000001110000000000000000000110011
1100110010000C1110000011100011100000C011100000000001101100000011C00C00000000111001000000C000100101101100111
11C11000000001100000000100000001000000000000010000001000000001111111111110000000000110000000110110100101111
1111C0000C10000000001100000011C00000111000C0111C0000000111000000000000000000000000C11100000011000010010C111
1111111111111111111111111111111111111111111111111111111111111111111111111111111111111111C110000110C00001111
11111111111111111111111111111111111111111111111111111111111111111111111111111111111111111111111111111111111
