sssssssssssssssssssssssssssssss
s00000000000000000000000000000s
s00000000000000000000000000000s
s000000000ddd00000000000000000s
s021dDHCcMeBGKWSsaabbttxxyyzzEs
s000000000ddd00000000000000000s
s00000000000000000000000000000s
sP0000000000000000000000000000s
sssssssssssssssssssssssssssssss
