1111111111111111111111111111111
1P00d00000000000000000000000001
1000ed00ed000D2D00McM00C1C1C101
1000ded0de00D00BD0M00c010000001
1000ededed0020S020McM00C1E10001
1000de0ede00D0s0D0M00001C100001
1000ed00ed002B0020M0000C0000001
1000de00de0002D200M00001C1C1C01
1000000000000000000000000000001
1111111111111111111111111111111
