1111122111112111111111
11eeeeeee0000020000001
1e20eee1D011100Hey0001
1eeeee1001000101eeeee2
10001e101001001WHats01
100000c0101S20110000C1
1e00001010001010GOOD01
1Bee0e1001c10012222221
10eGeBc10000010C00WHy1
10Bee01011111CMaH00001
10E1110000e000000BOOt1
111P0000e00000000000C1
1111111111111111111111
