1111111111111111111111111111111
1111111111111111111111111111111
1100d00CCCCC0000111010101000011
11P000CC111CC0000C00b010b0000y1
1100000CCCCC0000111010101000011
1111111111111111111111111111111
1111111111111111111111111111111
11c100zDDD1100D01D1100D000d0111
1xC00d1DCD100D100110C010011d0y1
1100c11DDDz0D100C0D0K001c101111
1111111111111111111111111111111
1111000111111111111111111111111
1111c1000D000d0011000000e000011
1x0011eDe100ODd00C0C0e101e100E1
1100DD00010dDcDd010000e00000011
1111111111111111111111111111111
1111111111111111111111111111111
