11111111111111111
10000000a00000001
10000000100000001
1P00000111c000001
10000001a100000E1
11111111111111111
