111111111111111111111111111111
111111P11111111a1111C0CCDc11y1
11dt1101111000001cDD1011111111
11D111000000111111100000000001
1100000c111D1DDD1D1e1101111101
11011101ee101D1c1e1e11x1100001
110011111e1010D1D00011111011E1
1110D001Me10101t1D010000001101
10001101C00D1de1c10101111x1101
1c111C01y11c1a0000000001111c01
11111111111111c111111111111111
