11111111111111
1P0000G0000001
10111111111101
10100000000101
10101111110001
10101000G11011
10100C110110E1
1011100101c1B1
10000C0000C001
11111111111111
