11111111111111111111
10P011x011WDcD1eeae1
100D0M100110D00ce0M1
10DeD0110011000e00e1
100D0001101100000ee1
1011M00010D10G0M11e1
110y100100100001y011
100010010D1000010001
1x01000a1000000010E1
111111111ccc11111111
