1111111111111111111111
1c00000000E000000000M1
1eeB00000eee00000B00e1
1000C000e111e000C00001
10CCC0Ge1D0D1eG0CCC001
1B0CCC0e10P01e0CCC0B01
100C000e1D0D1e000C0001
1000B000e1D1e000B00e01
1ce0000000000000000ec1
111111111M1c1111111111
