11111111111111111111111111111111
111e0C00000eeDHDe1c000C0000ee1e1
1y00CDC00Be1e0E0eeecee0e1eCDc1e1
111e0C001ee1e000e1111e0001eHO1e1
11eee1e1e11eeeee1eeeee1101eee1e1
111e1e1e0000000e1e0000000e1111e1
11e1eee00eeeee0e1e0ee11e0c1eeee1
11eeeee0ee111e0e1e00e1C0e1000ee1
1eyCCee0e00C1e0e11e0ee10ee0e0e11
11eCDee0e0ec1e0eeee0e000000e0Me1
111e0000e0ee1e000000eee1110eeee1
111ee1e000111Heeee0e11eee00111e1
1Wee111e111e1D111e0ee11e0000e1e1
1dDDWW11e1e000CC1e0eeeeeeee00e01
1DDWD11e0000eeCD1e000000000000e1
1Ddd11ee0ee0e1ee1ee1eDD1Deet0e11
1WDW1eed01e00e11111C111111De0111
1dD111ed1DD0000000000eee1eeeD111
1011e11d1011e00eeee10000000ee111
1B1e0DDd1S110000e11eeDee01e11111
11e0D11O11e0D1eDe111DD1e0000e111
11e0H11111e011eDDe100H1110ee1111
1cCCc1111100111eCe1c1111e0Pe1111
1cCM111111t11111ee111111eeee1111
11c11111111111111111111111111111
