11111c11
1P000001
1000e0E1
11M11111
