11111111111111
1P100000e00011
1000000e000011
10000000e00011
1000000C000e11
100000M000eE11
11111111111111
