1111111111111
1P000000e0001
1000000eS0001
10000CCCe000kkkkkkkkkkkkk1
10000000000e1
10000cMc00eE1
1111111111111
