1111111111111
1P00000000001
100WWWWW00BB1
10000CCC0GBB1
1W00000B0eBB1
10cMcMcc000E1
1111111111111
