11111111111111111
1taybxPybzaxzcEt1
11111111111111111
