11111111111111111
1taybxPybzaxztEc1
11111111111111111
