11111111111111111
10000000000000001
10000000P00000001
10000000M00000001
10000000000000001
1000000CEC0000001
11111111111111111
