111111111111111111111111111111
1000000000000e1000000000000001
111100000000001000000000000001
1CC0000E0000001000000000000001
111100000P00001000000000000001
100000000000001000000WWWWW0001
10000C000000001000000WWWWW0001
100000111000000000000WWWWW0001
100000101000001000000WWWWW0001
100000111000001000000000000001
100000000000001000000000000001
100000000000001000000000000001
111111111111111111111111111111
