11111111111111111111111111111
10000000000000000000000000001
10000000000000000000000000001
10000E00000000000000000000001
100000000000CCCCCC00000000001
100000000000CCCCCC00000000001
100000000000CCCCCC00000000001
100000000000CCCCCC000000P0001
10000000000000000000000000001
10000000000000000000000000001
10000000000000000000000000001
11111111111111111111111111111
