1111111111111111
1111111111111111
11P0111111110011
1100111111110011
1100111111110011
1100111c11110011
1100000011110011
1100111c11110011
1100111111110011
11001111111a0E11
1100a11111111111
1111111111111111
