1c1111111111111111
1PC000000000000Ec1
111111111111111111
