111111111111111111
1P0000010000000001
10010C0100C1001101
100111010111001001
1000000001000000E1
111111111111111111
