111111111111111111
1P10001011010001E1
10101010DD01C10101
10101110DD01110101
100000001100000001
111111111111111111
