1111111111111111111111111
10000010C0010010000000001
10P0C0C000C1H0D0C000C00a1
10000010C001001000C000001
1011D111111111111111D1111
101d11111111O11D111111121
1000001000011000000000001
1000C0C0C0CaC0C0C0C0C0001
10000010000100000000000E1
1111111111111111111111111
