1111111111111
1P0D10C00000c
100C01DDD0011
100D0x1x10001
10011111111t1
111000100C011
1H001C1D11D11
1z0D1E10z10t1
1111111c11111
