1111111111111111
1P1E010000111b11
10C10100C0000H11
1011000100001t11
101c01221111b1e1
10111000000100c1
1D00002S200001t1
1111111211111111
