1111111111111111111
10P01000000000e0001
100010S011110010c01
1000100010C10010001
10C0111110110011111
1000e00000010000001
100000e1000000000E1
1111111111111111111
