1111111111111111111111111111111111111111111111111111111111111111111111111111111111111111111111111111111111111111111111111111111111111111111111
1111111111111111111111111111111111111111111111111111111111111111111111111111111111111111111111111111111111111111111111111111111111111111111111
11P000000C000000000000000000000000000000000000000000000000000000000000000000000000000000000000000000000000000000000000000000000000000000000011
1100000000000000000000000000000000000000000000000000000000000000000000000000000000000000000000000000000000000000000000000000000000000000000011
1100000000111100000000000000000010000000000000000000100000000000000000000000000000000000000000000001000000000000000000000000000000000000000011
1100000011111110000000000000001111000000000000000011110000000000000000000000000000000000000000000011100000000000000000000000000000000000000011
1100000110000110000000000000000110000000000000000001100000000000000000000000000000000000000000000011000000000000000000000000000000000000000011
1100000110000110000000000000111111111110000000001111111111100000000000000000000000000000000000000011000001000000000000000000000000000000000011
1100000110000110000100001000000110000000000000000001100000000000000000000000000000000000000000000011000011100000000000000000000000000000000011
1100000110001110001100011100000110000000001100000001100000000000000000000000000000000000000000000011000001000000000000000000000000000000000011
1100001110001100011100001100000110000000011110000001100000000001111111010000110111110000001111111011000000000011011111000000111111101100000011
1100001100001100001100001100001100000000000111000011000000000011000001110001111100011000011000001111000111000111110001100001100000111100000011
1100001100001100011000001100001100000000001101100011000000000011000000110000110000001100110000000110000011000011000000110011000000011000000011
1100001100001100011000011000001100000000011000110011000000000110000000110001100000001100110000000110000110000110000000110011000000011000000011
1100001111111000011000011000001100001100110100110011000011000110000001110001100000001100110000000110001110000110000000110011000000110000000011
1100000111100000001111110000000111111001100011100001111110000011111111010001100000011000011111111011000110000110000001100000111111110000000011
1100000000000000000000000000000000000000000000000000000000000000000000000000000000000000000000000000000000000000000000000000000000110000000011
1100001111111111111111111111111111111111111111111111111111111111111111111111111111111111111111111111111111111111111111111100110000110111000011
1100000000000000000000000000000000000000000000000000000000000000000000000000000000000000000000000000000000000000000000000001100000110000000011
1100000000000000000000000000000000000000000000000000000000000000000000000000000000000000000000000000000000000000000000000001100000110000000011
1100000000000000000000000000000000000000000000000000000000000000000000000000000000000000000000000000000000000000000000000000111111000000000E11
1111111111111111111111111111111111111111111111111111111111111111111111111111111111111111111111111111111111111111111111111100000000001111111111
1111111111111111111111111111111111111111111111111111111111111111111111111111111111111111111111111111111111111111111111111111111111111111111111
