111111111111111111111111111111111111111111111111111111111111111111111111111111
100000000000000000000000000000000000000001000000000000000000000000000000000001
100000000000000000000000000000000000000001000000000000000000000000000000000001
1000000D0000000000000000000000000000000001000000000000000000000000000000000001
100000DDD000000000eee0000000000000000000010000000000000000000t0000000000000001
10000DDcDD00000000eee0000000000000000000010000CC00000000000001000000000CC00001
100000DDD000000000eee0000000000000000000010000CC00000000000001000000000CC00001
1000000D0000000000010000000000000000000001000000000000000000010000000000000001
1000000000000000000100000000000000CC000001000000000000000000010000000000000001
1000000000000000000100000000000000CC000001000000000000000000010000000000000001
100000000000000CCDD10000000000000000000001111111111111111111110000000000000001
100000000000000CCDD10000000000000000000001000000000000000000a10000000000000001
100000eee0000000DDD10000000000000000000001000000000000000000010000000000000001
100000eee00000DDDDD100000000000000000000010000000000CC000000010000000000000001
100000eee000DDDDDDD100000000000000000000010000000000CC000000010000000000000001
1000000000DDDDDDDDD10000000000000000000001000000000000000000010000000000000001
10000000CCeeeeeeeeeeeeeeeeee00CC0000000001000000000000000000010000CC0000000001
1eeeeeeeCC0000DDD0010000000000CC000000eee1000000000000000000010000CC0000000001
11111111111111eee001000000000000000000eee1000000000000000000010000000000000001
1eeeeeeeeeeeeeeee001000000000000000000eee1000000000000000000010000000000000001
10000000000000eee001000000000000000000a001000000000000000010010000000000000001
100000000000000000011111111111111111111111000000000000000CC1110000000000000001
10000eee0000000000010000000000000000000001111111111111111CC0010000000000000001
10000eeeeeeeeeeeeee10000000000000000000001000000000000000100010000000000000001
10000eee000CC00000010CC000000000000000000100000000000000000001000000eeeee00001
10000000000CC00000010CC00000000000000000010000000000000000000100000ee111ee0001
100000000000000000010000000000000000000001c0000000000000000001000000eeeee00001
10000000000000000001000000000000000000000111111111D000000000010000000000000001
10000000000000000001000000000000000000000100000000DDD0000000010000000000000001
1000000000000000000100000000000000000000010000CC0000DDDD0000010000000000000001
100000000CC00000000100000000000000000000010000CC0000000DDDDDD10e1eee1111110101
100000000CC00000000100000000000000000000010000000000000000000101CCCCCCCCc1C101
100000000000000000010000000000000000000001000000000000000000010eCe111ee111C101
100000000000000000010000000000000000000001000000000000000000010eCCCCCCCCCCC101
1000000000000000000100000000000000CC000001000000000000000000010e111111111e1e01
10000000MM000000000100000000000000CC000001000000000000000000010000000000000001
10000000MM00000000010000000000000000000001000000000000000000010000000000000001
100000000000000000010000000000000000000000000000000000000000010000000000000001
10cDcDDD0000000000010000000000000000000000000000000000000000010000000000000001
1D0000000000000000010000000000000000000000000000000000000000010000000000000001
1P000000000000000001000000000000000000000t0000000000000000000100000000000000E1
111111111111111111111111111111111111111111111111111111111111111111111111111111
