1111111111111
100000P000001
1000000000001
1000000000001
10C0000000C01
1000000000001
1000000000001
100000E000001
1111111111111
