1111111111111
1000D0P01CCt1
1aee10000C1C1
11GOtO11D11D1
11111111dddd1
11Bed11c11111
1c000COC0e0a1
1c00CdEdC00e1
1111111111111
