1111111111111
10M010P01CWC1
10t010000C1C1
1000Da11D1WD1
11211111dddd1
1C0C000111111
1MC0000DeatH1
1C0C00E000001
1111111111111
