1111111M11111
1E0ee0000c0t1
1e0eM0ee00ee1
100ee0eDe0001
10e1001e0eC01
100e0ee000e01
1e000e00e0eH1
101eecD1e0Pt1
1111111111111
