1111111111111
100b11P11CC11
10e1d0K0CDDC1
100dd11C1CC11
1111111111111
1E0Me101BB1b1
100eeBB000001
1C000000B0B11
1111111111111
