1111111111111
1eedte1zD2ea1
1P001K1101He1
1eeHa11xd0dy1
1111c111111e1
1yBeDC10z10x1
11dE0De00e0e1
1bedC0C01t0b1
1111111111111
