1111111111111
11GG00P00GG11
1GG00CCC00GG1
1GG0CCCCC0GG1
1GG0CCCCC0GG1
1GG0CCCCC0GG1
1GG00CCC00GG1
11GG00E00GG11
1111111111111
