1111111111111
1H0B0001t00y1
1yPa100010BH1
1120C0B1D0011
1x0b01MBa0xc1
1011c00C0BHC1
1CBb0z10B0C01
1c1H0CE1Dz0t1
1111111111111
