1111111111111
1P0C000D00001
1eee0e0ee0e01
1EeCecece0et1
1111111111111
S0000Ce0000C1
1eeDe0e0s1111
1ceHe000000t1
1111111111111
