1111111111111
1x0000P0000x1
1100000000011
1110000000111
110C00000C011
1000001000001
1000000000001
100000E000001
1111111111111
