1111111111111
1x00D0P0D00x1
1000100010001
1111100011111
10C0000000C01
1011111111101
1000000000001
100000E000001
1111111111111
