1111111111111
1x00D0P0D00t1
1000100010001
1111100011111
10C0000000C01
1111111111111
1x000000000t1
100000E000001
1111111111111
