1111111111111
1x00D0P0D00t1
1000100010001
1111100011111
1x0C100000C01
1111111111111
10000000000t1
100000E000001
1111111111111
