1111111111111
1Dee10P0D00x1
100c100010001
1011111111111
10000t1x00C01
1111111111101
1t00001000001
10000DED00001
1111111111111
