1111111111111
1000D0P0D00x1
10B0100010001
1000111111111
10000c1x00C01
1111111111101
1c00001000001
100B0DED00001
1111111111111
