1111111111111
1000D0P0D00x1
10B0e000e0001
10e0eeeeeeee1
10000cex00C01
1eeeeeeeeee01
1c0000e00e001
100B0DED000e1
1111111111111
