1111111111111
1HCD10P010001
1a0x10001x101
1111111011101
1eeeG00000001
1111111c11111
1c000000010a1
100BED1000011
1111111111111
